byfreeshock : by free shock  
lightweight : lightweight  
themagnetic : Error 
theboundary : the boundary  
viscousself : viscous self  
inthispaper : in this paper  
theunsteady : the unsteady  
symmetrical : symmetrical  
normalforce : normalforce  
placeholder : placeholder  
transitional : transitional  
hasbecomethe : has become the  
exactconical : exact conical  
compressible : compressible  
wherethemean : where them e an  
afiniteregion : a finite region  
itiswellknown : it is wellknown  
thecontinuity : the continuity  
inarecentnote : in are cent note  
stackingstudy : stacking study  
timehistories : time histories  
thestewartson : the stewartson  
iftheboundary : if the boundary  
avehiclecanbe : Error 
analysisofthe : analysis of the  
skinstiffener : skins t if f e n r  
forcertainaero : force rt a in er o  
ateachoftwenty : at each of twenty  
inarecentpaper : in are cent paper  
asimplepicture : Error 
byusingakarman : by using a k rm n  
theauthorgives : the author gives  
fullydeveloped : fully developed  
supersonicwind : supersonic wind  
thepresenceofa : the presence of a  
whererisaplane : where r is a p l n e  
footsupersonic : foot supersonic  
aninductiondrag : an induction drag  
theadventofhigh : the advent of high  
dimensionalwind : dimensional wind  
lengthmechanism : length mechanism  
inarecentletter : in are cent letter  
theeffectsoflow : the effects of low  
airfoilprofiles : airfoil profiles  
transferandskin : transfer and skin  
experimentsonaxi : experiments on axi  
atheoryofrounded : at he or y ofr o u nd e d  
comparisonofheat : comparison of heat  
theuseofboundary : the use of boundary  
asurveyofthestate : as u r v e y of th s t a  
reasonsforenquiry : reasons fore n q u i r y  
withtheabovetitle : with the above title  
analternativesemi : an alternatives e m i  
flowairfoiltheory : flow airfoil theory  
whichdiscussedoil : which discussed oil  
theresultsofshort : there s u l to f h or t  
localheattransfer : local heattransfer  
inthissummarypaper : in this summary paper  
itispointedoutthat : it is pointed out that  
intheanalysisofone : in the analysis of one  
speedresearchontwo : speed research on two  
undertheabovetitle : under the above title  
formsolutionsofthe : forms o l u t in s f he  
considersamaterial : considers a m t er i l  
theauthorrewritesv : the author rewrites v  
themodifiedslender : them o d if i e s l n r  
theeffectofastrong : the effect of as tr on g  
theintensityofshock : the intensity of shock  
anapproximatemethod : an approximate method  
inthefirstpartofthe : in the first part of  
calculationofsecond : calculation of second  
thehotouterinviscid : the hot outer inviscid  
isextendedtoinclude : is extended to include  
itisshownthatthetwo : it is shown that the two  
ananalysisofthepart : an al y s i of the part  
aseparatedflowfield : as e para t d flow f i l  
fromahoveringaerial : from a hovering er i l  
theeffectofaforward : the effect of a for w r d  
anintegralexpression : an integral expression  
inthepibalhypersonic : in the pibal hypersonic  
therelationofthetime : there la tion of the time  
transfercoefficients : transfer coefficients  
thedevelopmentrocket : the development rocket  
ofplanelaminarmotion : of plane laminar motion  
theresultsaregivenof : there s u l t are given of  
infirstapproximation : in first approximation  
thebasisofanythermal : the basis of any rm al  
withoblateatmosphere : with oblate atmosphere  
distributionandforce : distribution and force  
pressuremeasurements : pressure measurements  
layerequationsandthe : layer equations and the  
amethodispresentedfor : a method is presented for  
thevelocitypotentials : the velocity potentials  
thelaplacetransformof : the laplace transform of  
airandheliuminjection : air and helium injection  
thepaperdealswithself : the paper deals with self  
intherecentpaperbyzuk : in there cent paper by zuk  
thestabilitytheoryofa : the stability or y of a  
thereflectionofashock : Error 
methodsbasedonoblique : methods based on oblique  
pitchingmomentandfull : pitchingmoment and full  
withaviewtothestudyof : with a view to the study of  
theshapeandnatureofthe : the shape and nature of  
examinationofthecrocco : examination of the crocco  
aninvestigationatafree : an investigation at a free  
tunnelinvestigationwas : tunnel investigation was  
anewmethodhasbeengiven : an e w mth o d has b n g iv  
amultiwebwingstructure : Error 
ananalysisisgivenofthe : an al y s ii given of the  
thedynamiclongitudinal : the dynamic longitudinal  
platetheoryforturbulent : plate theory fort u r b l e n t  
someofthetheoriesfortwo : some of the or i e s ft w o  
thisnotediscussesthetwo : Error 
waveisformedinfrontofit : wave is formed in front of it  
testsonthestorageheater : tests on the storage heater  
werecarriedoutusingahot : were carried out using a hot  
theforciblebucklingofan : the forcible buckling of an  
resultsoffluttertestson : results off l u t er e s on  
lagrangianmethodsinheat : lagrangian methods in heat  
themodelusedisthatoftwo : them o de l used is that ft w  
thedifferentialanalyser : the differential analyser  
theequationsforplanartwo : the equations for planar two  
transversemagneticfields : transverse magnetic fields  
continuoussupersonicwind : continuous supersonic wind  
inchsupersonicwindtunnel : inch supersonic windtunnel  
theflowpastaslenderdelta : the flow past as lend er delta  
exceptinexceptionalcases : except in ion al cases  
adiscussionoftheintegral : a discussion of the in t e g rl  
detraandhidalgohaveshown : detra and hidalgo have shown  
acircularcylinderwithtwo : Error 
presentationofstagnation : presentation of stagnation  
beenextendedtoincludenon : been extended to include non  
theintensityofturbulence : the intensity of turbulence  
withthedevelopmentofhigh : with the development of high  
anexactsolutionoftheheat : an exact solution of the heat  
theflowaroundslenderwing : the flow around slender wing  
amethodisdevelopedforthe : a method is developed forth e  
theclampedplateproblemin : the clamped plate problem in  
acollectionhasbeenmadeof : a collection h s been m de of  
weconsiderinthisreportthe : we consider in this report the  
theprofilesandthicknesses : the profiles and thicknesses  
thetransonicflowroundatwo : the transonic flow round at w o  
recentresultsoftestsinthe : recent results of tests in the  
comparisonsaremadebetween : comparisons are made between  
thispaperstudiesthesteady : this papers t u d i e s h a y  
testshavebeenmadeinthreen : tests have been made in three n  
fromananalysisoftheworkof : from an al y s i of the work  
fromastudyofexistingsonic : from as t u dy of e x is ing sonic  
adescriptionisgivenofthen : a description is given of then  
followingthemethodsoflyon : following them et h o d s fly n  
astudywasmadeofthefatigue : as t u dy w made of he f a i g e  
withtheintroductionofhigh : with the introduction of high  
thetransientperformanceof : the transient performance of  
oftheperfectlyelasticthin : of the perfectly elastic thin  
ofnewtoniantheoryforblunt : of newtonian theory for blunt  
paperisatranslationofchap : paper is at r an s li on of chap  
aninvestigationtodetermine : an investigation to determine  
themethodsoftheoperational : them et h o d s ft e pr at in al  
asimplemethodofdetermining : as im p l e mth o d ft rm in g  
measurementshavebeenmadeof : measurements have been made of  
theproblemsofsolidblockage : the problems of solid blockage  
aconewithabluntnosetipanda : a cone with blunt nose tip nd  
theeconomyofadesigndepends : the economy of a design depends  
resultsaregivenoflocalskin : results are given of local skin  
controlsurfaceflutterofthe : Error 
temperatureprofilesandheat : temperature profiles and heat  
thispaperisabriefsummaryof : this paper is ab r i e f sum may o  
aninvestigationoftheeffect : an investigation of the effect  
resultsofhypersonicflutter : results of hypersonic flutter  
astudyhasbeenmadeofthetime : as t u dy h been made of e im  
thetheoryoflaminarboundary : the or y of laminar bound a r  
testsweremadeofashortblunt : tests were made of as h or t b l u n  
asimplemethodofcalculating : Error 
aninvestigationismadeofthe : an investigation is made of the  
atechniqueisdiscussedwhich : Error 
stateequationsofmotionfora : state equations of motion for a  
anewstatictubeandanewpitot : an e w static t u b dp i o  
theperformancetheoryforhigh : the performance or y f high  
thepracticalneedforresearch : the practical need for research  
estimatesofthevariationwith : estimates of the variation with  
thepresentpaperconcernswith : the present paper concerns with  
thetumblingmotionofvehicles : the tumbling motion of vehicles  
theproblemofcircumferential : the problem of circumferential  
improvementindetectedsignal : improvement in detected signal  
resultsofanexperimentalheat : results of an experimental heat  
inhisdetailedstudyofthenose : in his detailed study of then o s e  
ageneraltheoryofsteadythree : age n er al theory of steady three  
whengasesflowathighvelocity : when gases flow at highvelocity  
theauthorsgiveabriefaccount : the authors give ab r i e f account  
thisreportpresentsequations : this report presents equations  
windtunneltestshavebeenmade : windtunnel tests have been made  
suitableformsoftheequations : suitable forms of the equations  
bytransformationofvariables : by transformation of variables  
theroutinetestingofaircraft : the routine testing of aircraft  
duringthermalfatiguetesting : during thermalfatigue testing  
bymeansofsuitableexpansions : by means of suitable expansions  
thisreportisrestrictedtothe : this report is restricted to the  
extensionofpreviousanalyses : extension of previous analyses  
thebucklingofsimplysupported : the buckling of simply supported  
distributioninaboundarylayer : distribution in ab o u nd ary layer  
itisdemonstratedthattheshock : it is demonstrated that the shock  
approximateexpressionsforthe : approximate expressions forth e  
dataarepresentedwhichprovide : data are presented which provide  
thisreportcontainstheresults : this report contains there s u l t  
usingthetechniquesofboundary : using the techniques of boundary  
existingmethodsofcalculating : existing methods of calculating  
amethodforcomputingthesteady : a method for computing the s t e dy  
discussionofvariousturbulent : discussion of various turbulent  
aninvestigationofsomeaspects : an investigation of some aspects  
tunneltestshavebeenperformed : tunnel tests have been performed  
itisshownthatshockwaveswhose : it is shown that shockwaves whose  
afteranextensivesurveyofmean : after an extensive survey of m e  
thisisthefirstofthreepartsof : this is the first of three parts  
asatellitevehicleisdescribed : Error 
areviewisgivenofdevelopments : are view is given of developments  
resultsarepresentedfromawind : results are presented from a wind  
bythedistortionofcoordinates : by the distortion of coordinates  
thisreportgivestablesofthetwo : this report gives tables of the two  
pressuredistributionshavebeen : pressuredistribution s have been  
withthevonmisestransformation : with the von mises transformation  
theeffectofairdragonsatellite : the effect of air drag on satellite  
corridorsformannedvehiclesare : Error 
ananalysisismadeforthelaminar : an al y s ii made forth e laminar  
windtunnelexperimentswithside : windtunnel experiments with side  
asummaryofexactsolutionsofthe : as u mm ary of exact so l tions the  
andrapidmethodbywhichboundary : and rapid method by which boundary  
forinitialstagnationpressures : for initial stagnation pressures  
amethodisdescribedfortreating : a method is described fort re ting  
ontheoriesofvorticitytransfer : on theories of vorticity transfer  
anexactgeneralmethodofsolving : an exact general method of solving  
distributedroughnessbandsofno : distributed roughness bands of no  
aheatconductionproblemissetup : Error 
themethodofgeneralisedconical : Error 
anexaminationhasbeenmadeofthe : an examination has been made of the  
ageneraltheoryofcreepbuckling : Error 
measuredasafunctionofpressure : measured as a function of pressure  
thenonviscousflowthroughamixed : then on viscous flow through a mixed  
theproblemoftransientliftontwo : the problem of transient lift on two  
amethodofpredictinglaminarheat : a method of predicting l m in r he t  
onthebasisofthehypersonicsmall : on the basis of h y per s i cm all  
anexperimentalinvestigationwas : an experimental investigation was  
theequationsoftheboundarylayer : the equations of boundarylayer  
thisnotedescribestransientwall : Error 
panelfluttertestswereconducted : panel flutter tests were conducted  
thedeflexionofauniformlyloaded : the deflexion of a uniformly l o de d  
oftheinfluenceofboundarylayers : of the influence boundarylayer s  
tohelpfillthegapintheknowledge : to help fill the gap ink now led g e  
anewandgeneralmethodforsolving : an e w d g n r al mth of o s l vi  
turbulentrecoveryfactorandheat : turbulent recovery factor and heat  
anexperimentalinvestigationhas : an experimental investigation has  
semivertexangleconewerestudied : semivertex angle cone were studied  
intheflowpastaslenderdeltawing : in the flow past as lend er delta w g  
therateofenergytransferbetween : the rate of energy transfer between  
thecamberandtwistdistributions : the camber and twist distributions  
aninterpretationofthedehoffman : an interpretation of the de h f m  
forthinshellstherelationbetween : forth in shells there la tion between  
accordingtotheclassicalboundary : according to the classical boundary  
amethodforfindingrealandcomplex : a method for finding re l nd co m p e x  
abladedesignforahighlyloadedtwo : ab la de sign for a highly l o d t w  
asaresultofstudiesmadeduringthe : as are s u l to ft d i e m a r n g th  
thedisplacementofaflatplatebent : the displacement of a fl t p l e b n  
amethodofanalysisbasedonslender : a method of n l y s i be do e d r  
thetheoryofsupersonicflowaround : the or y of supersonic flow around  
thecaseofcreepbucklingofcolumns : the case of creepbuckling columns  
theoreticalbucklingcoefficients : theoretical buckling coefficients  
aninvestigationhasbeenconducted : an investigation has been conducted  
thepresentstateofknowledgeonthe : the presents t a e of know ld go n  
theproblemofdeterminingthetotal : the problem of determining total  
transienttemperaturesinaerofoil : transient temperatures in aerofoil  
thepolygonmethodofwoodsisusedto : the polygon method of woods is used to  
amethodofdesigningpumpimpellers : a method of designing pump impellers  
byconsiderationofantisymmetrical : by consideration of antisymmetrical  
ageneralmethodisdescribedwhereby : age n er al method is described w he by  
recenttheoreticalandexperimental : recent theoretical and experimental  
thenonlinearboundaryvalueproblem : then on linear boundary value problem  
theblasiusequationsubjecttothree : Error 
theenergyseparationforlaminarlow : the energy separation for laminar low  
discussionofapreviousapplication : Error 
thebasicequationsundersimplified : the basic equations under simplified  
layerequationshavebeenintegrated : layer equations have been integrated  
developsasideforcelikethatofafin : develops aside force like that of a fin  
bucklingtimesofinitiallystraight : buckling times of initially straight  
thepresentreportgivesanaccountof : the present report gives an account of  
aninvestigationhasbeenmadeinthen : an investigation has been made in then  
ananalysisismadeoftheoscillatory : an al y s ii made of the oc i l at or  
convectionflowandheattransferofan : convection flow and heattransfer of an  
itisproposedtoshowthattheboundary : it is proposed to show that the boundary  
orderboundarylayerdisturbancesare : order boundarylayer disturbances are  
thegeneralcharacterofexperimental : the general character of experimental  
thehypersonicviscousflowpastaflat : the hypersonic viscous flow past a fl t  
theinteractionbetweentheturbulent : the interaction between turbulent  
thehypersoniclaminarboundarylayer : the hypersonic laminarboundary layer  
dimensionalheatconductionproblems : dimensional heat conduction problems  
itisshownthatinthepotentialflowof : it is shown that in the potentialflow of  
thispaperisconcernedwiththedesign : this paper is concerned with the design  
anapproximatesolutionforthesteady : an approximates o l u t in f r he sea dy  
aninvestigationwasconductedinthen : an investigation was conducted in then  
theopticalandphysicalpropertiesof : the optical and physical properties of  
thetheoryofthelaminarboundarylayer : the or y of laminar bound a rl er  
theextensionalandflexuralequations : the extensional and flexural equations  
thenaturalfrequenciesofacontinuous : Error 
systematictestshavebeenmadeatamach : systematic tests have been made at a mc h  
byamethodsimilartothatdevelopedbys : by a methods im i l rt o th t de v e p d s  
inthecourseofinvestigatingboundary : in the course of v e s t i g ab o u nd ary  
ananalysisispresentedwhichpredicts : Error 
thesupersonicflowaboutabluntbodyof : the supersonic flow about ab l u n t body of  
theproblemoftheflowalongaflatplate : the problem off low along a fl t p l e  
theresultsoftestsonpressurizedring : there s u l to ft e np r i z d n g  
resultsoffatiguetestscarriedoutatr : Error 
asimplemethodisgivenwhichissuitable : as im p l e mth o d is g iv n which s u it ab  
mosttreatmentsofmagnetohydrodynamic : most treatments of magnetohydrodynamic  
walledcircularcylindersisreplacedby : walled circular cylinders is replaced by  
inthepresentreportthestabilityoftwo : in the present reports tab i l t y of w o  
hasbeenextendedtothecylindricalcase : has been extended to the cylindrical case  
theflowfieldanalyzedconsistsofathin : the flow field analyzed consists of at h in  
thepossibilityofagradualinstability : the possibility of a g r du lin s t b i l y  
measurementshavebeenmadeofthedirect : measurements have been made of the direct  
thispaperpresentsnumericalresultsof : this paper presents numerical results of  
themomentumequationwasuncoupledfrom : Error 
existingtheoriesforthestantontubeare : existing theories forth e stanton t u bar  
whichisarevisionandextensionofnacatn : which is are vi on and e x tn s i of naca  
theelectricalconductivityofanionized : the electrical conductivity of an ionized  
atheoreticalinvestigationofsymmetric : Error 
thetheoryofstabilityofdynamicsystems : the or y of s tab i ltd n a mc t e m  
thepresentpapercontainsanapplication : the present paper contains an application  
andpressuredistributionofatriangular : and pressuredistribution of at r i an g u la  
methodapplicabletobodiesofrevolution : method applicable to bodies ofr e v o l u t in  
vibrationinaircraftstructurecanalmost : vibration in aircraft structure can almost  
thevalueofthecompressivestressatwhich : the value of compressive stress at which  
flightmodelswereflowntomeasurethezero : flight models were flown to measure the zero  
astudyismadeofthestationaryconvection : Error 
inspecialcircumstanceswherealargework : in special circumstances where al a r g e w o k  
thereportdescribesaninvestigationinto : there p or t describes an in v e s i g ao no  
theincompressiblelaminarboundarylayer : the incompressible laminarboundary layer  
dataarepresentedonsideforcesgenerated : data are presented on sideforce s generated  
thedevelopmentofsupersoniccompressors : the development of supersonic compressors  
alongthecentrelineoftheworkingsection : along the centreline of workingsection  
theeffectofinternalpressureonthesmall : the effect of internal pressure on small  
thetheoryofcompressibleflowinalaminar : the or y of compressibleflow in al a m r  
theproblemofthebucklingofthincircular : the problem of buckling thin circular  
thereportdescribesteststoobtaindirect : Error 
thepurposeofthisnoteistodiscussthetwo : Error 
somewhatmoreaccuratethanthoserecently : somewhat more accurate than those recently  
thispaperpresentsamethodofcalculating : Error 
astudyhasbeenmadeoftheflowdevelopment : as t u dy h been made of e flow dvl op m n  
theinviscidflowofaperfectgasoverblunt : the inviscidflow of a perfect g so v er blunt  
currentinterestintheproblemofinviscid : current interest in the problem of viscid  
thepairofmotionequationsforentryintoa : the pair of motion equations fore n tr y it o a  
astudyismadeoftheunsteadyflowaroundan : as t u dy is made of he n sea flow a r o d  
amethodispresentedforcomputingrapidly : a method is presented for computing r p i d l y  
thedeterminationofcolumndeflectionsand : the determination of column deflections and  
threecentrifugalimpellerswithparabolic : three centrifugal impellers with parabolic  
controlledmissileisoneinwhichmanoeuvre : controlled missile is one in which manoeuvre  
experimentaldataarepresentedonboundary : experimental data are presented on boundary  
andcirculatedtothecivildefenceresearch : and circulated to the civil defence research  
afterarathercompleteexploratoryprogram : after a rt he r complete e x p l o y g m  
presentedaretheresultsofanexperimental : presented are there s u l to fan experiment a  
thesimplelinearizedtransonicflowtheory : the simple linearized transonic flow or y  
randomvibrationisvibrationwhichresults : random vibration is which results  
inmixturesoftwodifferentgasesorliquids : in mixtures of two different gases or liquids  
magneticeffectsareconsiderednegligible : magnetic effects are considered negligible  
atheoreticalstudyismadeofsomecruciform : Error 
analyticalsolutionsoftheprandtlboundary : analytical solutions of the prandtl boundary  
experimentshavebeenconductedtomeasurein : experiments have been conducted to measure in  
thelaminarboundarylayerinaxialflowabout : the laminarboundary layer in axial flow about  
therateofdecayofellipticsatelliteorbits : the rate of decay elliptic satellite orbits  
itisfoundthatforprescribedvelocityfield : it is found that for prescribed v e l oc y f i d  
thehyperboliccharacterofthedifferential : the hyperbolic character of differential  
theuseofmodeltestsinthepredictionoffull : the use of model tests in prediction full  
thegoverningequationsofanincompressible : the governing equations of an incompressible  
theeffectsonbasepressureofjetmachnumber : the effects on base pressure of jet machnumber  
ageneralmethodisdescribedforcalculating : Error 
circularringwingwithabodyofrevolutionon : circular ring wing with ab o dy f rev l u t in n  
theproblemofevaluatingthebendingmoments : the problem of evaluating bending moments  
anexperimentalinvestigationofthelaminar : an experimental investigation of the laminar  
utilizingtheresearchresultsofpreviously : utilizing there search results of previously  
thisstudyoftheflowaboutanairfoilinanear : this study of the flow about an airfoil in e a r  
rateatwhichairdensitypvarieswithheighty : rate at which air density pv a r i e s w th hg h t y  
theinstabilityoftheacceleratedinterface : the instability of accelerated interface  
flowtheoremforcompressiblenonsteadyflow : flow theorem for compressible nonsteady  
thetendencyinthepasthasbeentoassumethat : the tendency in past has been to assume that  
thepaperconcernsthehydrodynamicturbulent : the paper concerns hydrodynamic turbulent  
theproblemofpredictingthecharacteristics : the problem of predicting characteristics  
aninvestigationwasconductedinahypersonic : an investigation was conducted in a hypersonic  
alinearizedsolutionbasedonadiscontinuous : al in e a r i z d so l u to n b s co  
thecharacteristicsofthepositionandformof : the characteristics of position and form  
theinfluenceoftransversemagneticfieldson : the influence of transverse magnetic fields on  
determinethepressureloadsproducedonaflat : determine the pressure loads produced on a fl t  
considerableinterestinthecharacteristies : considerable interest in the characteristies  
soundpropagationofconvectionontheonehand : sound propagation of convection on the e hand  
hoffhaspresentedformulaswhichcanbeusedin : hoff has presented formulas which can be used in  
injectionprocesshasbeenproposedasamethod : injection process has been proposed as a method  
thetitleproblemsweresolvedforthetwocases : the title problems were solved fort w oc as e s  
severalauthorshaveinvestigatedtheboundary : several authors have investigated the boundary  
theequationfortheequilibriumofcylindrical : Error 
typeheatprotectionatthestagnationpointofa : type heat protection at the s t a g n i op o f  
inordertodeterminethevelocitydistribution : in order to de term et he velocitydistribution  
ananalysisispresentedofsupercircularentry : Error 
anidealizationoftheflowsystemusedbypotter : an idealization of the flows y stem used b potter  
thepostbucklingbehaviorofinitiallyperfect : the postbuckling behavior of initially perfect  
thecriticalflutterspeedisevaluatedforatwo : the critical flutter speed is evaluated for at w o  
verysuitableforusewithanautomaticcomputer : very suitable for use with an automatic computer  
anapproximatetheoryofthebasepressureintwo : an approximate theory of the base pressure in two  
singularitiesareconsideredinthesolutionof : singularities are considered in the solution of  
measurementsweremadeofloadsinducedonaflat : measurements were made of loads induced on a fl t  
themethodofexpressingthevelocityincrement : Error 
thispaperisconcernedwiththesimilitudelaws : this paper is concerned with the similitude laws  
explicitsolutionsareobtainedforthebending : explicit solutions are obtained forth e b nd ing  
theequationsaregivenforthelaminarboundary : the equations are given for laminarboundary  
discussionofasimilaritybetweenthepressure : discussion of as im i la rt y between the pressure  
anapparatusisdescribedwhichpermitsthemode : an apparatus is described which permits them o de  
byintroducingthesimilarityconcepttothetwo : by introducing the similarity concept to two  
thehovercraftisthefirstoperationalbritish : the hovercraft is first operational b r it h  
thisreportinvestigatesthewavedragofbodies : this report investigates the wave drag of bodies  
measurementsweremadeofthepressureinablunt : measurements were made of the pressure in ab l u n t  
thefrequencyspectraandvibrationmodesofthin : the frequency spectra and vibration modes of thin  
tofacilitatethedevelopmentofhighspeedaxial : to facilitate the develop m e n f high s p d axial  
liapunovandhistheoryofstabilityisdiscussed : Error 
approximateanalyticalsolutionsarepresented : approximate analytical solutions are presented  
simplifiedexpressionsdescribingthetransfer : simplified expressions describing the transfer  
anexaminationoftheeffectsofcompressibility : an examination of the effects compressibility  
isstudiedanalyticallybyaperturbationmethod : is studied analytically by a per t u r b ion meh o d  
pressuremeasurementsweremadeonaslendercone : Error 
intwopreviouspaperstheauthorshavediscussed : in two previous papers the authors have discussed  
amathematicaltreatmentofthecoupledmotionof : Error 
expansiontheoryisutilizedtoobtainequations : expansion theory is utilized too b t a in eq u ions  
thecurveofdragagainstmachnumberforstraight : the curve of drag against machnumber for straight  
aprocedureispresentedwherebythecomposition : a procedure is presented whereby the composition  
thenewtoniantheoryofimpacthasbeenshowntobe : then e w to n i at h or y of m p act as b so  
themaintypesofaxialcompressorsaredescribed : Error 
walkdentheoryfortheestimationofthestrength : walkden theory forth e s t imai on of h r n g  
vonkarmanandtsienhaveshownthatunderelastic : von karman and tsien have shown that under elastic  
theoryofthincylindricalshellsareintegrated : theory of thin cylindrical shells are integrated  
carriedoutforunyawedbodiesofrevolutionwith : carried out for unyawed bodies ofr e v o l u t in w i h  
inordertobringouttheimportanceoftheleading : Error 
theparticletreatmentisappliedtoastudyofthe : the particle treatment is applied to as t u dy of  
theauthorpointsouttherelationoftheintegral : the author points out relation of integral  
aproblemofcreepstabilityofcolumnsandplates : a problem of creep s t b i l y co u m n dp e  
pohlhausenmethodisextendedprimarilytosixth : pohlhausen method is extended primarily to sixth  
advancesinthepracticaldevelopmentofboundary : advances in the practical development of boundary  
scaleredundantstructureanalysesarecurrently : scale redundant structure analyses are currently  
theflowofviscouselectricallyconductingfluid : the flow of viscous electrically conducting fluid  
thispaperdealswiththeapplicationofnumerical : this paper deals with the application of numerical  
theflowofacompressiblefluidpastaspherefixed : the flow of a compressible fluid p s there fixed  
therehaverecentlyarisensomequestionsastothe : there have recently arisen some questions as to the  
combinedfreeandforcedconvectiveheattransfer : combined free and forced convective heattransfer  
undertookthedesignandfabricationofavariable : undertook the design and fabrication of a v rib l e  
asolutionisobtainedfortherateofchangeofsemi : Error 
astudywasmadeattransonicspeedsbythenacawing : Error 
thestressesanddisplacementsinapartlyplastic : Error 
tablesofthermodynamicandtransportproperties : tables of thermodynamic and transport properties  
asimplegraphicalnetworkisusedtodeterminethe : Error 
comparativetestsweremadeonsevenconventional : Error 
thegreatestorleastvalueofafunctionofseveral : the greatest or least value of a functions e v rl  
asystematicstudyofinducedpressuresonaseries : Error 
theanalysisgivenbyprobsteinandelliottforthe : the analysis given by probstein and elliott for  
aformulafortheinitialbucklingloadsforclamped : a form u l forth e in it i bc kg o d s f r cm p  
thedominatingfactorsinstructuraldesignofhigh : the dominating factors instruct u r al design of high  
schlierenphotographshavebeencompiledofthetwo : schlieren photographs have been compiled of the two  
threemethodsofapproximatingthedeflectionsand : three methods of approximating the deflections and  
dimensionalinviscidnonequilibriumflowsofatwo : dimensional inviscid nonequilibrium flows of at w o  
theoreticalinvestigationisconsideredofthetwo : theoretical investigation is considered of the two  
thethermodynamicandtransportpropertiesofhigh : the rm o dynamic and trans pr t per i e s f hg h  
attentionhasbeencalledbynumerousauthorstothe : attention has been called by numerous authors to the  
inthetheoryofnonstationaryflowsaboutairfoils : in the or y of non station a rf low s b out i o l  
thetermflutterisusedheretodenotemaintainedor : the term flutter is used here to denote maintained or  
theflowinducedbythesuddencontactbetweenasemi : the flow induced by sudden contact between as e m i  
analysismethodisderivedanddemonstratedforthe : analysis method is derived and demonstrated forth e  
inhisstudyoftheeffectofroughnessontransition : in his study of the effect roughness on transit i  
thispaperanalyzesthebendingofasectorialplate : Error 
anoutlineisgivenoftheusesoffluttermodelsasan : an outline is given of the uses flutter models as  
thevortextuberepresentsasimpledeviceinwhicha : Error 
anintegralmethodfortherapidcalculationofheat : Error 
recordingshavebeenmadeofthestrainsinducedina : recordings have been made of the strains induced in a  
itwasobservedthatthetwoexistingboundarylayer : it was observed that the two existing boundarylayer  
ananalyticalinvestigationismadeofaprecession : Error 
theproblemoftheiondensitydistributionarounda : the problem of ion density d is tr i but a r o u n  
achangeinflowpatternthatwasobservedasthefree : Error 
thephenomenonofcumulativedamageunderrepeated : the phenomenon of cumulative damage under repeated  
stationaryconvectivemotionofaconductingfluid : stationary convective motion of a conducting fluid  
variousobservationsandpreliminaryexperiments : various observations and preliminary experiments  
plateswithattachmentstoheaviermembersalongthe : plates with attachments to heavier members along the  
theoreticalandexperimentalresultsarepresented : theoretical and experimental results are presented  
indealingwiththesteadylaminarviscousflowovera : in deal gw it h test e a dy l m r viscous f o w v  
amachinefortestingturbinenozzlesbythereaction : Error 
anapproximatemethodisusedtoobtaintheinjection : Error 
parallelflowofanelectricallyconductingviscous : parallel flow of an electrically conducting viscous  
thereynoldsequationsofmotionofturbulentflowof : there y no ld s equation of m o t i u r b l e n f w  
inarecentpaperamethodwaspresentedforobtaining : in are cent paper a method w s pre e n t d for ob g  
ageneralmethodofsolutionisgiveninthispaperfor : age n er al method of so l u t i o s g v e h p a f r  
theproblemofstallflutterisapproachedintwoways : the problem of stall flutter is approached in two ways  
steadyapproachtoflutterutilizesexperimentalor : steady approach to flutter utilizes experimental or  
thispaperpresentstheresultsofthefirstpartofan : this paper presents there s u l to ft he f i rt para n  
thispapersetsoutthemethodnowusedbytheauthorof : this papers et so u t he m h o d n w s e by a rf  
inthispapertheincompressibleboundarylayerovera : in this paper the compressible boundarylayer over a  
thisreportdescribesanexperimentalinvestigation : this report describes an experimental investigation  
thestreamfunctionfortheshearflowwithhyperbolic : the stream function for shear flow with hyperbolic  
themajorscaleeffectsathighsubsonicandtransonic : Error 
areviewismadeofexistingliteratureconcernedwith : Error 
ordersolutionforthelaminarcompressibleboundary : orders o l u t in f r he a mc m p e s i b nd y  
intheearlierattemptsatfindingthejumpconditions : in the earlier attempts at fd g jump conditions  
thepurposeofthepresentpaperistoderiveasystemof : the purpose of present paper is to derive as y stem  
anearlyuniformshearflowwasobtainedintheworking : an early uniform shear flow was obtained in the work g  
tunnelresultsareanalyzedtoderiveasemiempirical : Error 
theauthorstudiestheproblemoffindingtheshapeofa : the authors t u d i e s pr ob l m off n g h a p of  
theaerodynamicproblemsassociatedwithpropulsion : the aerodynamic problems associated with propulsion  
theexperimentallydemonstratedriseandsubsequent : the experimentally demonstrated rise and subsequent  
thedistributionofdeflectionandbendingmomentina : the distribution of deflection and bending moment in a  
severalmethodshavebeendevelopedforcomputingthe : several methods have been developed for computing the  
theauthorsrepeattheearliercalculationsofpiercy : the authors repeat earlier calculations of piercy  
afterabriefreviewofmethodsofcalculatingtheflow : Error 
theweissingermethodfordeterminingadditionalspan : the weissinger method for determining additional span  
athighspeedstheturbulentboundarylayerwashingthe : at highspeed s the turbulent boundarylayer w a h ing  
anexpressionhasbeenderivedforthemassflowthrough : an expression has been derived forth e mass flow through  
anexactsolutionandacloselyconcurringapproximate : an exact solution d a closely concurring p r o x im t e  
atheoreticalanalysisismadeoftheconstantpressure : at he or et i cal an al y s made of t co np re u  
directmeasurementsofsupersoniclocalskinfriction : direct measurements of supersonic local skinfriction  
thedetachedshockinfrontofabluntbodyinhypersonic : Error 
thisnotereferstopaperofsametitlebyfeldmaninarsj : this note refers top a per of s met it l e by fd m n i r j  
thisnoteattemptstoextendthediscussionbystatinga : this note attempts to extend the discussion by stating a  
amodifiedtechniquefortheoperationofaguntunnelis : a modified technique forth e op rt ion of gun t u n li s  
bodytheoryisextendedtoderivefirstapproximations : body theory is extended to derive first approximations  
thispaperisanattempttobringtogethertheimportant : this paper is an attempt to bring get he rt im p o t  
thispaperwillbeconcernedwithsomepropertiesofthe : this paper will be concerned with some properties of the  
athypersonicspeedsthedragareaofabluntnoseismuch : Error 
thefundamentalinvestigationsofvonkarmanandtsien : the fundamental investigations of von karman and tsien  
aphysicalflowmodelisdevisedbasedontheconceptsof : Error 
bodyapproximationoflinearizedcompressibleflowis : body approximation of linearized compressibleflow is  
thespatialdistributionofnoisesourcesalongajetis : the spatial distribution of noise sources along a jet is  
inthisreportatheoryofthinairfoilsofsmallcamberis : in this report at he or y of th airfoils small camber is  
ithasbeenestablishedinthepastthatthereisacertain : Error 
cylindersinfreeflightinapressurizedrangehavebeen : cylinders in free flight a pressurized r n g e h v b  
thereareinsupersonicaerodynamicsmanysituationsof : there are in supersonic aerodynamics many situations of  
acorrectionismadefortheequationtocomputetheratio : a correction is m de forth e q u tion to co p t h r i o  
pressuresweresimultaneouslymeasuredinthevariable : pressures were simultaneously measured in the variable  
analyticalpredictionsaregivenforthedevelopmentof : analytical predictions are given forth e dvl op m n to f  
manyofthephenomenathatoccurintheworldaroundusare : many of the phenomena that occur in world around us are  
thevelocitycomponentsofthefluidfarfromtheairfoil : the velocitycomponent so ff l u i d far from a rf o  
flutterresearchonreflectionplanemodelsofstraight : Error 
thepositionandstrengthofthefrontshockwaveatlarge : the position and strength off r on t shockwave al age  
knownthatwhentheflowiseverywheresubsonicinafield : known that when the flow is everywhere subsonic in a field  
thispaperpresentsthesolutionoftheheatflowproblem : this paper presents the solution of heat flow problem  
stiffeneraluminumalloypanelsconsistingoffourbays : stiffener aluminumalloy panels consisting off our bays  
inthispaperatheoreticalsolutionisdevelopedforthe : in this paper at he or et i cal so l u to n s de v e op d ft  
thereportisconcernedwiththevortexflowwhicharises : there p or t is concerned w i h e v x fl oc ars  
thetransienttemperaturedistributionandthethermal : the transient temperature distribution and rm al  
resultsaregivenofpressuremeasurementsandboundary : results are given of pressure measurements and boundary  
theeffectsofcontaminationofheliumbyairuponstatic : the effects of contamination helium by air upon static  
themethodpresentedinthepreviouspartsisemployedto : them et h o dp re s e n t d i pv up arm p l y  
flowpropertiesbehindshockwavescausedbybluffbodies : flow properties behind shockwaves caused by bluff bodies  
aninvestigationtodeterminethefeasibilityofusingan : an investigation to determine the feasibility of using  
sonicflowsaroundslenderbodiesandhaspointedoutthat : sonic flows around slender bodies and has pointed out that  
sponsoredexperimentalinvestigationofthelocationof : sponsored experimental investigation of the location  
forafamilyofconesofvarioussemiapexanglesbluntedby : for a f mil y oc ones o v r i us s e m p x n g lb l u t db  
thereportdescribesexperimentsdevisedtoinvestigate : there p or t describes e x r im n s d vi o i g a  
thispapershowshowtocalculatetherateofheattransfer : this papers how s to calculate the rate of heat tr an f er  
experimentsarereportedontheinteractionofturbulent : experiments are reported on the interact i of turbulent  
themechanicsofthekinetictheoryofgasesisemployedto : Error 
experimentalresultsgatheredinrecentyearsforbinary : experimental results gathered in recent years for bar y  
ananalysiswasmadeoftheflowconditionsdownstreamofa : an al y s i w a m de of the fl oc on d t re  
articleisacontinuationofanearliernoteonpapersbyli : article is a co n t i u o f er l e p s by  
publishedworkoncreepbucklinghasimpliedthatfailure : published work on creepbuckling has implied that failure  
thebucklingofathincylindricalshellsimplysupported : Error 
thelagrangianthermodynamicequationsofirreversible : the lagrangian rm o dynamic eq u at in s f i r e v b l  
thepapersetsdowntheequationsofmotionforasymmetric : Error 
insomecoolingproblemsassociatedwithhighenergyflows : in some cool g problems associated with h i e n r y flows  
thefreeturbulentmixingofasupersonicjetofmachnumber : the free turbulent mixing of as up er sonic jet mach n u m b  
theresultsofexperimentsonaxialloadingofcylindrical : Error 
thispapersummarizestheopticalandphysicalproperties : Error 
aninvestigationofthebasepressurebehindwedgesatmach : Error 
thereportisafirstattempttodeviseacalculationmethod : Error 
aprogramtoinvestigatetheaerodynamicheattransferofa : a pr o g rm t in v e s i h r dy n mc ff  
amethodofcalculationisdevelopedtocomputetheoverall : Error 
theproblemofaccuratelypredictingthepressureandwake : the problem of accurately predicting pressure and wake  
recentexperimentalstudiesoftransitionfromlaminarto : recent experimental studies of transition from laminar to  
thepurposeofthisresearchprogramwastoinvestigatethe : the purpose of this research program was to investigate  
theconditionofimmediatefreezingofthemassfractionof : the condition of immediate freezing mass fraction  
theproblemofpredictingthemeanvelocityonstreamlines : the problem of predicting mean velocity on streamlines  
thegeneralsolutionofthestrongblastwaveisfoundinthe : the general solution of strong blast wave is found in  
theoryandexperimentsoftheflutterofabuckledplateare : Error 
rangehypervelocityvehiclesarestudiedintermsoftheir : range hypervelocity vehicles are studied inter ms of their  
theproblemofoptimalzoomclimbmaneuveringofaturbojet : the problem of optimal zoom climb maneuvering at u r b o jet  
aircraftstructureslocatedinthenearnoisefieldofajet : aircraft structures located in then e a r no is f i ld o j t  
assumingthatcontinuumflowenergyequationinaboundary : assuming that continuum flow energy equation in ab o u nd ary  
whencertainconditionsarefulfilledforthicknessratio : Error 
inthischapterweshallmainlyconsiderproblemsofsteady : in this chapter we shall m al y consider pr ob l e so f s t a d  
layerheattransferisanalyzedforthecaseofasinusoidal : Error 
theactionofacolumnintheplasticrangeisanalyzedonthe : Error 
amosttroublesomeparadoxhasexistedforanumberofyears : a most troublesome pr do x h s e it d for n u m b r of y  
thetemperatureisdeterminedasafunctionofpositionand : the temperature is determined as a function of position nd  
thegeneralbendingtheoryofshellsundertheinfluenceof : the general bending or y of shells under influence  
thisisalucidintroductiontotheeffectsofdissociation : Error 
anapproximationtotheheattransferrateacrossalaminar : an approximation to the heat tr s f er rate acr o al a m in r  
thisisasurveyofcertainrecentadvancesmadeinthestudy : Error 
transfercoefficientsandrecoveryfactorsarepresented : transfer coefficients and recovery factors are presented  
ananalyticalandexperimentalstudyismadeforinelastic : Error 
alargeproportionofthecurrentresearchprogrammeofthe : Error 
flowpropertiesinnozzleswerecalculatedandchartedfor : flow properties in nozzles were calculated and charted for  
theuseofmodelsforstructuraltestinvestigationsinthe : the use of models for structural test investigations in  
inthefirstpartoftheinvestigationananalysisismadeof : in the first part of v e s t i g ao n a l y m d  
theproblemstudiedmayberegardedasaproblemofgeometry : the problems t u d i e may b r g a s p o l m f y  
amethodwhichmaybeusedathighsupersonicmachnumbersis : Error 
amethodispresentedfortheestimationoffatiguedamageto : a method is presented forth e s t im ion off i g u d m o  
thepostbucklingcharacteristicsofanaxiallycompressed : the postbuckling characteristics of an axially compressed  
thetorsionalbucklingstrengthofacylinderintheplastic : Error 
thisisanaccountofaninvestigationinwhichoscillations : this is an account of investigation in which oscillations  
transitionfromlaminartoturbulentflowinthehypersonic : transition from laminar to turbulent flow in the hypersonic  
asolutionisgivenforthecaseofthelaminarboundarylayer : Error 
theprofileofasymmetricairfoilofunitlengthwitharound : the profile of asymmetric airfoil unit length with around  
newmethodsarepresentedfortheanalysisoftransientheat : new methods are presented forth e analysis of trans in that  
analogymethodforthesolutionofelasticplateproblemsis : Error 
asimpleformulaisgivenforthepressuredistributiononan : as im p l e form u a is g iv n forth r s d t i b o  
thisreportpresentsatheoreticalanalysisoftheboundary : this report presents at he or et i cal an al y s of t bound a r  
formulasfortheinviscidflowpropertiesonthesurfaceofa : formulas forth e inviscidflow pr o t is n h s u rf a cf  
resultsaregivenofawindtunnelprogrammemadetostudythe : results are given of a windtunnel pr o g rm m e d t s u y h  
thetheoryofthesteadyflowofaviscouscompressiblefluid : the or y of s t e a d flow vi co u m pr i b l f  
theinterferencebetweenthewingsandthetailsurfacesofa : Error 
thispaperisconcernedwiththeproblemofobtaininghigher : this paper is concerned with the problem of obtaining higher  
atheoreticalanalysishasbeenmadeforanimpacttubeofthe : Error 
paperisagoodreviewofknowledgetodateonconvectiveheat : Error 
thisanalysisincludesthespecificcontributionsofatoms : this analysis includes the specific contributions of atoms  
thetheoryfortheplasticbucklingofcolumnswhichappears : the or y f plastic buckling oc o l u m n s which appear  
anexperimentalstudyofawinginapropellerslipstreamwas : an experimental study of a wing in propellers lip s tr e m w  
transitionalheattransferonabluntbodyunderhypersonic : Error 
experiencehasshownthatthefluctuatingloadsinducedbya : experience has shown that the fluctuating loads induced by a  
chartsarepresentedfordeterminingcompletetemperature : charts are presented for determining complete temperature  
ontheforebodyofmanypracticallyinterestinghypersonic : Error 
byexpandingthevelocitypotentialinanasymptoticseries : by expanding the velocity potential in an asymptotic series  
conditionsofthermodynamicequilibriumisextendedtonon : conditions of thermodynamic equilibrium is extended to non  
thepurposeofthepresentnoteistogiveanexactsolutionof : the purpose of present note is to give an exact solution  
theproblemsofheattransferinturbulentshearflowalonga : the problems of heattransfer in turbulent shear flow along a  
dataarepresentedwhichwereobtainedfromatransonicwind : data are presented which were obtained from at r an sonic wind  
inmanywingvibrationanalysesitisfoundnecessarytotake : in many w g vibration analyses it is found necessary to take  
asimpleandrelativelyaccurateanalyticapproximationis : Error 
theeffectsofstreamvelocitygradientsonairfoilmaximum : the effects of stream velocity gradients on airfoil maximum  
aparticleapproachisusedtostudytheflowpatternarounda : Error 
asanaidtotheaerodynamieistinthedesignofairframesfor : as an aid to the aerodynamieist in design of airframe s for  
theeffectsofasmalljetofairexhaustingfromthenoseofan : the effects of as m all jet air exhausting f r on o sea n  
atheoryisdevelopedwhichdescribestheeffectofageneral : at he or y is developed which describes t e ff co f a g n rl  
axisymmetricviscousflowpastunyawedveryslenderbodies : axisymmetric viscous flow past unyawed very slender bodies  
earlierstudiesassumeanaverageheatofformationofatoms : earlier studies assume an average heat off or mat ion of atoms  
onafinnedmissilewhosewingsaredeflectedintoanaileron : on a finned missile whose wings re deflected into n i l er  
itwillbeshownthatthedifferentialequationsforaheated : it will be shown that the differential equations for a he t e d  
supporteddiscussionoftheuseofanintermediateelliptic : supported discussion of the use an intermediate elliptic  
thepresentreportdescribesanewmethodfortheprediction : Error 
plateproblemsinvolvingfreeedgeshavebeenhistorically : plate problems involving free edges have been historically  
highreynoldsnumberhypersonicstagnationflowoverablunt : high reynolds number hypersonic stagnation flow over ab l u n t  
anumberofbluntbodieshavingshapesthatmaybesuitablefor : an u m ber of b l n to d i e s h a v g p t y for  
asimplifiedmethodhasbeendevisedfordeterminationofthe : asimplified method has been devised for determination of the  
authordiscussestheproblemofdeflectionofacantilevered : Error 
thetrailleftintheatmospherebyabodymovingathypersonic : Error 
itisnowknownthatthehypersonicsimilaritylawderivedfor : it is now k nth at the hypersonic similar y law derived for  
experimentalandtheoreticalresearchhasbeenconductedon : experimental and theoretical research has been conducted on  
inthecontinuousquestforimprovedmeansoftransportation : in the co n t u o sq e s f r im pv d m a p i  
themixinganddivergenceofasupersonicjetexhaustinginto : them i x n g add v er e co f as up soc j th a us t o  
dimensionalincompressibleflowoffluidalongthecornerof : dimensional incompressible flow off l u i d ao n g the core r of  
theoreticalblockagecorrectionsarepresentedforabodyof : theoretical blockage corrections are presented for ab o dy f  
areexaminationhasbeenmadeoftheuseofsimpleconceptsfor : Error 
circularcylindricalshellsisexpressedinaformanalogous : circularcylindrical shells is expressed in a form n log o us  
thedesignofstructurestoresistjetnoisefatiguedemandsa : the design of structures to resist jet noise fatigue demands a  
thepurposeofthispaperistopresentamethodofcalculation : Error 
paperdescribesresultsofnumericalsolutionoftheviscous : paper describes results of numerical solution the viscous  
observationsofrotatingstallhaveshownthatawidevariety : observations ofr o t a ing s l h v e w n i dry  
numericalcomputationshavebeenperformedfortheboundary : numerical computations have been performed forth e boundary  
availabledataontheeffectsofsuctionandinjectiononskin : Error 
atheoreticalstudyismadeoftheeffectofpressuregradient : Error 
ananalysisismadeofexperimentallydeterminedmodeshapes : an al y s ii made of experiment ld eter m in e do d h a p  
thispaperillustratesthedevelopmentandapplicationofan : this paper illustrates the development and application of an  
thispaperdevelopsanewmethodfordeterminingthebuckling : Error 
theequationsobtainedbychienforthenonlineardeflection : the equations obtained by chien for nonlinear deflection  
aformulaforthesupersonicvelocityfieldintermsofagiven : Error 
sincetheintroductionofmomentummethodsinboundarylayer : since the introduction of momentum methods in boundarylayer  
theproblemofpanelflutterofrectangularsimplysupported : the problem of panel flutter rectangular simply supported  
measurementsofstagnationpointheattransferarepresented : measurements of stagnationpoint heattransfer are presented  
abriefreviewismadeoftheavailableinformationconcerning : Error 
anewmethodisproposedtocalculatethevelocityandpressure : Error 
theuseofpistontheorywasrecentlyadvocatedforsupersonic : Error 
treatsthegeneralclassofflowproblemscharacterizedbythe : treats the general class off low problems characterized by  
inordertosimplifytheprocessofestimatingtheaerodynamic : Error 
atheoryisderivedtopredictthestressesanddeformationsof : Error 
theintegralmethodofbelotserkovskiihasbeencarriedoutto : the integral method of belotserkovskii has been carried out to  
astudyhasbeenmadeofthesideforcegeneratedbyinjectionof : Error 
atheoryispresentedtopredictthebucklingtemperatureofan : Error 
anapproximatetheoryonthephenomenaofinteractionbetween : an approximate theory on the phenomena of interact i between  
theeffectsofcompressibilityonthesteadymotionofahighly : the effects of compressibility on steady m o t i a hg h l y  
calculationsarepresentedfortheproblemofthestabilityof : calculations are presented forth e pr ob l m of th s tab ii t y  
ageneraltheoryisdevelopedforthecaseoflargedeflections : Error 
presentednoteproposesalinearizedreactionrateparameter : Error 
paperstudiescompressiblelaminarboundarylayerinadverse : papers t u d i e s co m pr b l an a r on yy n v  
afourieranalysisofthelinearisedtheoryexpressionforthe : a fourier n l y s i of the er e do r x p o  
atheoryhasbeendevelopedforsmallbendingandstretchingof : at he or y has been developed f small bending and stretching o  
controlofflowseparationbyfluidinjectionatonediverging : control off low separation by fluid injection at one diverging  
ananalysisismadeofturbulentconstantpressuremixingfora : an al y s ii made of turbulent co n t pre u re mix i g for a  
theprincipleoftheminimumofthetotalpotentialisemployed : the principle of minimum total potential is employed  
thepresentpapercontainsasetoftablesofcompleteelliptic : Error 
completeinviscidflowfieldsaboutthreemodelaxisymmetric : complete inviscidflow fields about three model axisymmetric  
ageneralizedwaveequationisderivedforsounddisturbances : age n er al i z e d w a v q u to s for o tr bc  
resultsaregivenofmeasurementsinthecompressedairtunnel : results are given of measurements in the compressed air tunnel  
ofthecharacteristicequationsoftheaxiallysymmetricflow : of the characteristic equations axiallysymmetric flow  
simplemodelsareemployedtobringoutthelargeandimportant : simple models are employed to bring out the large and important  
analyseshavebeenmadeoftheeffectsofcoupledchemicalrate : analyses have been made of the effects coupled chemical rate  
accountsformolecularsizeandintermolecularforceeffects : Error 
shockshapeswereobservedandstaticpressuresweremeasured : Error 
anapproximatemethodofpredictingtheinterferencebetween : an approximate method of predicting the interference between  
anextensionofclassicalhypersonicsimilitudeisdeveloped : an extension of classical hypersonic similitude is developed  
atheoreticalstudyismadeofthebucklingofasandwichsphere : Error 
aninvestigationhasbeenmadetoexplorethepossibilitiesof : an investigation has been made to explore the possibilities of  
inthepresentinvestigationoftheflowofairinathinlaminar : in the present v e s t i g ao no ff low of a r h l m  
authorconsiderstheequationoftheyawingmotionofamissile : author considers the equation of yawing motion a missile  
amethodofcalculatingthetemperatureofthickwallshasbeen : Error 
aneffectivemeansofprotectingthesurfaceofahypersonicre : Error 
ithasbeenshownthattransversemagneticfieldsofpractical : it has been shown that transverse magnetic fields of practical  
theproblemofthermalbucklingofshellsarisesinconnection : the problem ofr m al buckling of shells arises in connection  
theformulasofsubsonicandsupersonicwingtheoryforsource : the formulas of subsonic and supersonic wing or y f source  
steadyflowaboutcurvedairfoilsathighsupersonicspeedsis : steady flow about curved airfoils at high supersonic speeds is  
authorintroduceshissurveybyabriefreviewofthehistoryof : author introduces his survey by ab r i e f v w o th t y  
ananalyticalstudyismadeofviscousflowinslenderchannels : Error 
anexperimentalinvestigationhasbeenmadeofsomeeffectsof : an experimental investigation has been made of some effects  
vangorcumhaspointedtointerestingandimportantanalogies : van gorcum has pointed to interesting and important analogies  
thispaperisconcernedwithbucklingofacircularcylinderof : Error 
discussionofseveralformsoftheenergyequationandoftheir : discussion of several forms the energy equation and i r  
thisreportconcernstheproblemofconstructingsolutionsfor : this report concerns the problem of constructing solutions for  
theuseofamagneticfieldtocontrolthemotionofelectrically : Error 
cosmonauticsiscurrentlyverymuchtotheforefrontinthenews : cosmonautics is currently very much to the forefront in news  
experimentalresearchhasbeenconductedontheeffectsofwall : experimental research has been conducted on the effects of wall  
wiremeasurementsinthefreestreamofasupersonicwindtunnel : wire measurements in the freestream of as up er sonic w d tunnel  
resonantbreathingfrequenciesandmodeshapesaredetermined : resonant breathing frequencies and modes h a p e sr d tr m in  
basedonthevariationalformulationoflinearthermodynamics : Error 
wingwithsharpleadingedgeshasbeenmadeinordertoascertain : Error 
dataarepresentedwhichshowtheeffectofajetonbasepressure : data are presented which show the effect of a jet on b s e pr u r  
thecornellaeronauticallaboratoryisconductingaprogramof : the cornell aeronautical laboratory is conducting a pr o g rm f  
relationsarepresentedforthecalculationofheattransferat : relations are presented forth e calculation of h at trans f r  
thetemperatureandthermalstressdistributionsareanalyzed : the temperature and rm al stress distributions area n y z e d  
twomethodsarepresentedfortheanalysisofcomplexlowaspect : Error 
thisveryshortpaperpresentsanapproximateprocedureforthe : this very short paper presents an approximate procedure forth e  
theequationsofmotionfortheflowofanidealdissociatinggas : the equations of motion for flow an ideal dissociating gas  
asurveyofexistinganalyticaltreatmentsofthesupersonicor : Error 
thispapergivesabriefsummaryofcurrentloadsinformationat : this paper gives ab r i e f sum may oc u n t loads o m a  
anumberofapproximatetheoriesforsupersonicandhypersonic : Error 
ionizedmoleculesandatomsoftheelementsnitrogenandoxygen : ionized molecules and atoms of the elements nitrogen oxygen  
manufacturingandmaintainanceofideallysharpleadingedges : manufacturing and maintainance of ideally sharp leadingedge s  
informationonatmosphericturbulenceobtainedfromcounting : information on atmospheric turbulence obtained from counting  
theinfluenceoflocalizedmasstransferatthenoseofaslender : the influence of localized mass transfer at nose as lend er  
briefdescriptionofexperimentsperformedbyusingshocktube : brief description of experiments performed by using shock tube  
thisnotepresentsasimplificationofamethodforcalculating : Error 
somenewsolutionsforsteadyincompressiblelaminarboundary : some news o l u t in s f ready cm pre i beam a r b nd y  
themethodsoftheclassicalaerofoiltheoryareusedtoderivea : Error 
anexperimentalstudyhasbeenmadetoinvestigatesomeaspects : Error 
gashypersonicflowparametersforheliumhavebeencalculated : gas hypersonic flow parameters for helium have been calculated  
thepressuredistributionandpressuredragofabluntbodywitha : the pressuredistribution and pressure drag of ab l u n t body w i h a  
thefirstportionofthispaperdescribesstudiesoftheinternal : the first portion of this paper describes studies internal  
withaviewtostudyingtheeffectofstrongtransversecurvature : with a view to studying the e ff cf strong tr n s v r cut u  
ananalysisispresentedwhichenablesthetemperatureprofiles : an al y s ii pre e n t d which ab l h m pr a u r of i  
attentionisdrawntoapreviousaccuratesolutiontotheproblem : Error 
thesupersonicaerodynamiccharacteristicsofinclinedbodies : the supersonic aerodynamic characteristics of inclined bodies  
authorstudiesthevelocityprofilesmeasuredbyothersinplane : authors t u d i e s h v l oc y pr of m a r b on p n  
inanattempttoavoidflowseparationattheleadingedgeofathin : in an attempt to avoid flows e para tion at th la d g of h  
theaccuracyandrangeofapplicabilityofthelinearizedtheory : the accuracy and range of applicability linearized or y  
aninvestigationoftransitionandskinfrictiononaninsulated : Error 
atheoreticalinvestigationhasbeenmadeofageneralmethodfor : at he or et i cal n v e s t go h ab m a do f g rl o d  
inrecentyearsgreatusehasbeenmadeofapproximatemethodsfor : in recent years great use has been made of approximate methods for  
measurementsofaverageskinfrictionoftheturbulentboundary : measurements of averages k in friction the turbulent boundary  
thisnotegivesamethodforthederivationofsuitableconstants : this note gives a method forth e d r iv tion of s u it b l co n t  
theequationsdescribingtheflowofanelectricallyconducting : the equations describing flow of an electrically conducting  
thisreportcontainssomefairlysimpleandeconomicmethodsfor : this report contains some fairly simple and economic methods for  
developmentofananalyticalrelationbetweenshockdetachment : Error 
formexpressionsandtablescomposedfromtheseexpressionsare : form expressions and tables composed from these are  
thisnotedescribesthemannerinwhichtheonsetoftheeffectsof : Error 
anapproximatetheoryofairfoilsinunsteadymotioninaviscous : an approximate theory of airfoils in unsteady motion a viscous  
thelinearisedtheoryofthinwingsisusedtocalculatepressure : the linearised or y of thin wings is used to calculate pressure  
asimpleexpressionisderivedforthenormalinjectionvelocity : Error 
approximateformulaeofthedisplacementthicknessandtheskin : approximate formulae of the displacement thickness and skin  
thesubsonicpotentialflowofacompressiblefluidpastasphere : the subsonic potentialflow of a compressible fluid p s there  
theresponseofasectionoftailplanestructuretobothdiscrete : Error 
aninvestigationhasbeenmadeofthepossibilityofcorrelating : an investigation has been made of the possibility correlating  
thispaperpresentstheresultsofaninvestigationconductedin : Error 
integrationofthevelocityprofileatthethroatofaflownozzle : integration of the velocity pr i l e at th r o a f w n z  
analysisoftheinfluencevariousaerodynamicparametershaveon : analysis of the influence various aerodynamic parameters have on  
theresultsarepresentedforaflighttestprogramusingafighter : there s u l t are pre e nd for a fig h pr o g rm in r  
accurateexperimentaldataaregivenontheshapeandthelocation : accurate experimental data are given on the shape and l oc at i  
adiabaticwalltemperaturesandrecoveryfactorsarecalculated : adiabatic wall temperatures and recovery factors are calculated  
thefirstpartofthepaperdealswiththelowspeedaerodynamicsof : the first part of paper deals with lowspeed aerodynamics  
thepresentworkisconcernedwiththedeterminationoftransient : the present work is concerned with determination of transient  
ananalysisispresentedfordeterminingthecollapseofcircular : Error 
existingconfigurationsofsupersonicportionofrocketnozzles : existing configurations of supersonic portion rocket nozzles  
equationsbasedonnewtonianimpacttheoryhavebeenderivedanda : Error 
theviscoustransversecurvatureeffectincompressibleaxially : the viscous transverse curvature effect incompressible axially  
experimentalconfirmationhasbeenrequiredthatinasupersonic : experimental confirmation has been required that in as up er sonic  
theproblemofdeterminingthestabilityofcompressibleviscous : the problem of determining stability compressible viscous  
asupersoniccompressordesignhavingsupersonicvelocityatthe : as up er sonic compressor design having s velocity at the  
secondapproximationforthepropagationandstructureofablast : Error 
thesimilaritylawsforaerothermoelastictestingarepresented : the similarity laws for aero rm o elastic testing are presented  
ontheassumptionthattheforcedmodesofvibrationofastructure : Error 
thisaddendumprovidesashortnoteontwoaspectsomittedfromthe : Error 
thetheoreticalestimationofthebucklingstrengthofacylinder : Error 
machnumberandflowangledistributionsintheworkingsectionof : machnumber and flow angle distributions in the work g section of  
hypersonicviscousflowoveraninsulatedflatplatewithsurface : hypersonic viscous flow over an insulated flatplate with surface  
thelinearizedequationsofmotionhavebeenderivedforarolling : the linearized equations of motion have been derived for a rolling  
timehistoriesofnoisepressuresneargroundlevelweremeasured : time histories of noise pressures near ground level were measured  
theboundarylayerbehindashockorthinexpansionwaveadvancing : Error 
thenonlinearlargedeflectionequationsofvonkarmanforplates : Error 
atheoreticalinvestigationofthevelocityprofilesforlaminar : at he or et i cal n v e s t go of l oc y pr f a m r  
representativeapplicationsaredescribedwhichillustratethe : representative applications are described which illustrate the  
themotionofthetrailingvorticesassociatedwithaliftingwing : Error 
anaccountisgivenofthehighsupersonicspeedtunnelnownearing : an account is given of the high supersonic speed tunnel now nearing  
astudyismadeofthesteadylaminarflowofacompressibleviscous : as t u dy is made of he seal a m in rf low co press i b l e vs  
thefrictionalforceonacylindermovingsteadilyparalleltoits : the frictional force on a cylinder moving s t e d i l y pr o  
authorinvestigatestheexistenceofaclassofsimilarsolutions : Error 
thethreepartialdifferentialequationsofthelaminarboundary : the three partial differential equations of laminarboundary  
amodifiedparaboliccurveappearstobeincloseproximitytothat : Error 
thevapourscreenmethodofflowvisualisationinsupersonicwind : the vapour screen method off low visualisation in supersonic w d  
thispaperpresentstheresultsofanexperimentalinvestigation : this paper presents there s u l to fan experiment a in v et i g to n  
severalslenderwingsofdeltaplanformwithsharpedgeshavebeen : several slender wings of delta planform with sharpedge s have been  
thetransformationofthecompressibleturbulentboundarylayer : the transformation of compressible turbulent boundarylayer  
analysisismadeoftheflowfieldproducedbyobliqueimpingement : analysis is made of the flow field produced by oblique impingement  
thevariousdifferencepatternsnecessaryforfinitedifference : the various difference patterns necessary for finite  
astudywasmadeofthelaminarcompressibleboundarylayerinduced : Error 
someillustrationsofthedifferencesthatmaybeexpectedbetween : some illustrations of the differences that may be expected t we e n  
interferometricmeasurementsweremadeofthedensityprofilesof : interferometric measurements were made of the density pr i l e s  
theleadingedgesandnosesofhypersonicvehiclesaresubjectedto : the leadingedge sand noses of hypersonic vehicles are subjected to  
stressandstraindistributionswerestudiedinlongflatplatesin : stress and strain distributions were studied in long flatplate s  
alargeamountofworkonconicalflowfieldswithoutaxialsymmetry : Error 
asolutiontosecondorderinthicknessisderivedforharmonically : Error 
amethodisgivenforobtainingthesolutionofthelaminarboundary : a method is given for ob t in g he so l u ion of m r bond y  
variousapproximationsarebeingsuggestedforobtainingsurface : Error 
anexperimentalinvestigationwasmadeofthepressuresinducedon : an experimental investigation was made of the pressures induced on  
itisshownthattherotationalstiffnessofacrossedflexurepivot : it is shown that the rotational stiffness of across e d fl x u r pivot  
anumericalsolutionoftheinviscidflowfieldaboutslenderblunt : Error 
thatthevelocitypotentialforthesubsonicflowofacompressible : that the velocity potential for subsonic flow of a compressible  
thepresentarticledescribesaninvestigationofseveraltypesof : the present article describes an investigation of several types  
itiswellknownthataccordingtoclassicalhydrodynamicsasteady : it is wellknown that according to classical hydrodynamics as t e a dy  
aseriesofexperimentswasperformedtodefinetheflowfieldonthe : as er i e so f x p m n t s w or do d h l o  
authorshowsthatthedifferentialequationsdefiningtheminimum : authors how s that the differential equation defining minimum  
thisreportpresentstheresultsofanexperimentalinvestigation : this report presents there s u l to fan experiment a in v et i g to n  
photothermoelasticexperimentswereperformedonalongmultiweb : photothermoelastic experiments were performed on al g multiweb  
theproblemofsolvingasymptoticdevelopmentsforallquantities : the problem of solving asymptotic developments for all quantities  
followingisananalyticalmethodfordesigningashroudwhichwill : Error 
representativeresultsarepresentedtoshowthecurrentstatusof : representative results are presented to show the currents t a us of  
amethodformakinganapproximatethicknesscorrectiontoslender : Error 
experimentalpanelflutterdatahavebeenobtainedatmachnumbers : Error 
thepaperdealswiththegeneralequationsforthevibrationofthin : the paper deals with general equations for vibration of thin  
aerodynamicstiffnessanddampingderivativeshavebeenmeasured : aerodynamics t if f n e s add a m p i g d r v h b u  
thecroccotransformationcombinedwithamanglertransformation : the crocco transformation combined with a m n g l er  
theshocktubeisshowntobeafeasibleresearchtoolforconducting : Error 
theflutterproblemofflatcircularpanelswithedgeselastically : Error 
anestimateisgivenofthedistributionofskinfrictionalforceper : Error 
sincetheconventionalelasticanalysisofthermalstressproblems : since the conventional elastic analysis ofr m al stress pr ob l e s  
resultsarepresentedofaninvestigationtodeterminetheeffectof : results are presented of an investigation to determine the effect  
overarangeofincidencesonthreesimplemodelsrepresentingthick : Error 
therequirementsforsimulatinginawindtunnelflutterconditions : there q u i re m e n t s for lag a w d l f r co o  
relatestoatechniqueforapproximatedeterminationoftheinitial : Error 
somerecenttheoreticalworkonslenderpointedwingsatzeroliftis : some recent theoretical work on slender pointed wings at zerolift is  
theproblemofinvestigatingthesimultaneouseffectsoftransient : the problem of investigating simultaneous effects transient  
inviewoftherecentcontroversybetweenliandglauertonthenature : in view of there cent controversy between li and glauert on then at u re  
aninvestigationwasmadetodeterminethesmallestsizeofisolated : an investigation was made to determine the smallest size of isolated  
asummaryisgivenofsomeofthemoreimportantexperimentalresults : as u mm ary is given of some them or e im p tan t x r n al s l  
thedevelopmentoftheflowpatternonasweptwingwithincidenceand : the development off low pattern on as we p twin gw it h incidence and  
theaerodynamicstabilityderivativesduetopitchingvelocityand : Error 
theimportanceofbodyliftliesinthefactthatatmoderateanglesof : the importance of body lift lies in fact that atm o de rate angles  
inthecourseofalargersurveyofsomeaerodynamiccharacteristics : Error 
chartshavebeenpreparedrelatingthethermodynamicpropertiesof : charts have been prepared relating the rm o dynamic pr per t i e s f  
liftfunctionsforwingsoffiniteaspectratiohavebeencalculated : Error 
theeffectofairdragonsatelliteorbitsofeccentricityelessthan : the effect of air drag on satellite orbits eccentricity e l s than  
adislocationclimbcreepmodelisconsideredwhichdoesnotrequire : Error 
areviewispresentedofthepublisheddataontheeffectofroughness : are view is presented of the p u b l he d at ao n effect r o g he s  
thisreportconsidersthelossofflexuralrigidityofathinwingdue : this report considers the loss off l e x u r a i g d t y of h n w  
thispaperisconcernedwithatheoreticalinvestigationoftheflow : this paper is concerned with at he or et i cal n v e s t go off low  
asublayerregionisintroducedinwhichtheintensityofturbulence : Error 
parkesandspragueandhuanghaveshownthatitispossibleforstrain : parkes and sprague huang have shown that it is possible for strain  
anintegralequationforobtainingtheunsteadyairforcesonfinite : Error 
ithasbeenshownbyludwiegthatthewallshearingstressofalaminar : it has been shown by ludwieg that the walls he a rings tr e s of l m in r  
generallyacceptedsolutionsfortheproblemsofhypersonicflight : generally accepted solutions forth e pr ob l ms of h y sonic fig t  
anasymptoticexpressionisfoundfortheliftdistributiononalong : an asymptotic expression is found forth e lift d tr i but on al g  
atheoryisdevelopedofthesupersonicflowpastabodyofrevolution : at he or y is developed of t supersonic flow p as ab o d rev l u in  
theequationsofmotionofcompressibleviscousflowwithvanishing : the equations of motion compressible viscous flow with vanishing  
anexperimentalinvestigationwasmadeofthepressuresinducedona : an experimental investigation was made of the pressures induced on a  
theoreticalaspectsinvolvedinthepredictionofstresslevelsfor : theoretical aspects involved in the prediction of stress levels for  
abriefdescriptionoftheslottedlinersusedisgiventogetherwith : Error 
inthepresentpaperashortsurveywillbegivenfirstofthebuckling : Error 
analyticsolutionsarepresentedforthetransientheatconduction : analytic solutions are presented forth et r an s i e nth at conduct on  
aninvestigationwasmadeatsubsonicspeedsinthelangleyhighspeed : an investigation was made at subsonic speeds in the l g e y h is p d  
anextensionofworkoflockandrogersandtheresultofcooperationby : an extension of work lock d rogers there s u l t co op er a ion by  
theauthorsgivetheexactsolutionforthethermaldistributionsfor : the authors give exact solution for rm al distributions  
themethodisbasedontheobservationofthedivergencethatoccursin : Error 
theflexuralvibrationsofthewallsofthincylindersareconsidered : the flexural vibrations of walls thin cylinders are considered  
experimentalstudiesofpanelflutterwereconductedatamachnumber : experimental studies of panel flutter were conducted at a mc h number  
ashallowsphericaldomesubjectedtolateralpressureisastructure : Error 
asimilarsolutionofthehypersonicviscousflowpastslenderbodies : Error 
thispaperdealswithtwolimitingcasesoflaminarheattransferover : this paper deals with two limiting cases of laminar heattransfer over  
thisnotecollectstogetherinonereportavailabletheoreticalwork : this note collects together in one report available theoretical work  
thecorrectdesignofintermediateverticalstiffenersonwebplates : the correct design of intermediate vertical stiffeners on web plates  
twoimportantfeaturesofhypersonicflowoverslenderorthinbodies : two important features of hypersonic flow over slender or thin bodies  
anaccountisgivenofexplicitsolutionsintermsofmathieufunction : an account is given of explicit solutions inter ms mathieu function  
amethodispresentedfortherapidcalculationoftheincompressible : Error 
measuredpressuredistributionsonconesarecomparedwithmodified : measured pressuredistribution so n co e s arm p a r d with m o if i  
thispaperconsiderstheproblemofcalculatingviscousaerodynamic : this paper considers the problem of calculating viscous aerodynamic  
aninvestigationoftheeffectsofaerodynamicheatingontheflutter : an investigation of the effects aerodynamic heating on flutter  
authorsextendvariationalprincipleofbiottovariouscasesofheat : authors extend variational principle of biot to various cases heat  
themainpurposeofthisinvestigationistoexaminethedependenceof : Error 
thevariationalandlagrangianthermodynamicsdevelopedinearlier : the variational and lagrangian rm o dynamics de v e l p d in a r i  
sponsoredanalysisoftheunsteadyperturbationsoftwodimensional : sponsored analysis of the unsteady perturbations twodimensional  
thispaperpresentsananalysisofthedeflectionsofandstressesina : Error 
thisreportdescribesamethodwhichhasbeendevelopedformeasuring : this report describes a method which h s been developed form e u ring  
adetaileddescriptionisgivenofamethodofapproximatingsolutions : Error 
thenonviscousincompressibleflowthroughatypicalpumpimpelleris : then on viscous incompressible flow through at y p i cal u mm e l r s  
thetotalliftresponsesofwingstosinusoidalgustsandtosinusoidal : the total lift responses of wings to sinusoidal gusts and  
thebasicproblemsoffluttertestinginthelowsupersonicspeedrange : Error 
amethodisdescribedformeasuringthedynamicstabilityderivatives : Error 
amethodispresentedforanalysisofthecompressibleflowbetweenthe : a method is presented for n l y soft he co m press i be f o w t e  
thelaminarjetmixingproblemswithheatreleasehavebeenformulated : the laminar jet mixing problems with heat release have been formulated  
energyexpressionsandtherelatedequilibriumequationsandnatural : energy expressions and there late de q u i lb rm e at on s n r al  
amethodofcalculatingthetotalquantityofheatthatpassesthrougha : Error 
thecompressibilitytransformationfirstintroducedbydorodnitzyn : the compressibility transformation first introduced by dorodnitzyn  
theflowofanidealdissociatinggasthroughanearlyconicalnozzleis : the flow of an ideal dissociating gas through early conical nozzle is  
aninvestigationhasbeenconductedinthelangleypropellerresearch : an investigation has been conducted in the l g e y pr or s arc h  
subsonicspanloadsandtheresultingstabilityderivativeshavebeen : subsonic span loads and there s u l ting tab ii t y de r iv a e h v b n  
thermalstressdistributionsinuniformcircularcylindricalshells : Error 
inconnectionwithastudyofthewakesbehindbodiesinhypersonicflow : in connection with as t u dy of he wakes be h db o d i e s y pr n cf l w  
chartsofthermodynamicpropertiesforequilibriumairarepresented : charts of thermodynamic properties fore q u i lb rm a r e p s n t d  
planeandaxisymmetrichypersonicgasflowsareconsideredwithshock : plane and axisymmetric hypersonic gas flows are considered with shock  
experimentsoftransonicflowpastacirculararcprofileshowthatthe : Error 
descriptivetheoryofdeformationhasbeendevelopedindetailforthe : descriptive theory of deformation has been developed in detail forth e  
aninvestigationhasbeenmadetodeterminejeteffectsoncylindrical : an investigation has been made to determine jet effects on cylindrical  
theboundarylayeronaslenderbodytendstobeverythickathypersonic : Error 
anattempthasbeenmadetoidentifythesignificantfactorsgoverning : Error 
aninvestigationwasmadetodeterminethecombinedeffectsofsurface : an investigation was made to determine the combined effects of surface  
themeasurementofrocketexhausteffectsonvehiclestabilityandthe : Error 
theinteractionbetweenshockwavesandboundarylayershasimportant : the interaction between shockwaves and boundarylayer s h aim p or tan t  
followingamajorassumptionthatenthalpyandvelocityaredependent : following a m j or s up tion th ten l p y nd v e oc it r d n t  
thispaperreviewssomeoftheexperiencetodateofusingsandwichtype : this paper reviews some of the experience to date using sandwich type  
anexactanalyticalsolutionoftheequationsofinviscidcompressible : Error 
aformulaforthevelocityfieldintermsofagivensurfacedistribution : Error 
arapidapproximatemethodforthedesignofcentrifugalcompressorsof : Error 
anexperimentalinvestigationhasbeenmadetoindicatethevalidityof : an experimental investigation has been made to indicate the validity of  
thehypersonicsimilaritylawasderivedbytsienhasbeeninvestigated : the hypersonic similarity law as derived by tsien h been investigated  
severalbluntbodieshavingshapesthatmaybesuitableforatmospheric : several blunt bodies having shapes that may be suitable for atmospheric  
thereciprocalequationsforrelatingtheincompressiblecirculatory : Error 
amodelisanalyzedwhichexhibitstheimportantpropertiesassociated : a model is n l y z e d which x h i b t s m p orr or oc  
somediscussionoftheacousticfatigueproblemofaircraftstructures : some discussion of the acoustic fatigue problem aircraft structures  
themotionofanincompressibleviscousfluidgeneratedbyacylinderof : Error 
directpitchingmomentderivativeshavebeenmeasuredusingthemethod : direct pitchingmoment derivatives have been measured using them et h o d  
ageneralisedconicalflowtheoryisusedtodeduceanintegralequation : Error 
theoriginalpapergaveacorrelationformulaforstagnationpointheat : the original paper gave a co r e l tion f o must g np in t  
thepresentpaperdescribesamethodfortheapproximatesolutionofthe : the present paper describes a method for p r o x im t e s l u in f  
aninvestigationhasbeenconductedatvariousreynoldsnumbersandlow : an investigation has been conducted at various reynolds numbers d low  
representativeexperimentalresultsarepresentedtoshowthecurrent : representative experimental results are presented to show the current  
streamofviscousincompressiblefluidoveranotheratrestisextended : stream of viscous incompressible fluid over another at rest is extended  
thetheorypreviouslydevelopedforthechangesintheperigeedistance : Error 
ageneralanalyticalprocedureisoutlinedforstructuressubjectedto : Error 
thispaperisapreliminaryandbriefaccountofsomeresearchcurrently : Error 
detailsaregivenofaprogrammeoftestsbeingmadeonsimilarsweptwing : details are given of a pr o g rm met e s t b in m d n ii l r w p  
theequationsofmotionofatumblingflatplateenteringanexponential : the equations of motion at u m b lin g fl p lee n t er i a e x o l  
themethodpreviouslydescribedhasbeenrefinedbytakingintoaccount : Error 
ananalyticalmethodforthedeterminationofeffectofshockcurvature : Error 
atmosphericdensitieshavebeenderivedfromartificialsatellitesin : atmospheric densities have been derived from artificial satellites in  
ontheassumptionofinfinitelysmalldisturbancestheauthordevelops : on the as sum p t i of n f e l y s m a du r bc u h o d v  
thestressesintheplasticrangearoundanormallyloadedcircularhole : the stresses in plastic range around an or m all y loaded circular hole  
theboundarylayerequationsforuniformflowparalleltothegenerators : the boundarylayer equations for uni m flow parallel to g e n r as  
astudyismadeoftheadvantagesthatcanberealizedincompressibleflow : Error 
thisreportdescribesanexperimentalinvestigationoftheequivalence : this report describes an experimental investigation of the equivalence  
anumberofauthorshaveconsideredtheeffectofslipontheheattransfer : Error 
thispaperconsiderstheimplicationsofrecentadvancesinknowledgeof : Error 
thelaminarflowofaviscousincompressiblefluidoveratwodimensional : the laminar flow of a viscous incompressible fluid over two dimension l  
toinvestigatethetheoreticalpredictionsoflighthillonaerodynamic : Error 
thispaperdiscussesthebasicprinciplesemployedintechniquesforthe : this paper discusses the basic principles employed in techniques for  
theindicialliftandmomentfunctionsaredeterminedapproximatelyfor : the indicial lift and moment functions are determined approximately for  
theapproximatetheoryofflowaboutslenderbodiesandwingsoriginated : the approximate or y off low about slender bodies and wings i g n at e d  
determinethestaticlongitudinalstabilitycharacteristicsofamodel : determine the static longitudinal stability characteristics of a model  
thedynamicbehavioroftwoprobevehiclesenteringamartianatmosphere : the dynamic behavior of two probe vehicles entering a m rt into sphere  
theeffectofvorticityonaxisymmetricstagnationpointboundarylayer : the effect of vorticity on axisymmetric s t a g n i p ob o u dry l y er  
testswereconductedatthelangleyresearchcenterontwowingedlifting : tests were conducted at the langley research center on two winged lifting  
thestaticaeroelasticstabilityordivergenceproblemisinvestigated : the static aeroelastic stability or divergence problem is investigated  
extensivetablesaregivenofpressurecoefficientsmeasuredatreynolds : extensive tables are given of pressure coefficients measured at reynolds  
thefreeoscillationsofathinpressurizedcylindricalshellcontaining : Error 
someexperimentalandtheoreticalstudieshavebeenmadeofaxisymmetric : some experimental and theoretical studies have been made of axisymmetric  
adiscussionofdifferencesarisingbetweenexperimentalandanalytical : Error 
theflowandheattransferaboutarotatingisothermaldiskarereexamined : the flow and heattransfer about a rott ing is or m ld k re e x in d  
thesubjectofmatricstructuralanalysishasbeentreatedintworecently : the subject of matric structural analysis has been treated in two recently  
theincompressibleflowofanelectricallyconductingfluidpastaporous : the incompressible flow of an electrically conducting fluid past a porous  
theresultsofapreliminaryexperimentalinvestigationtodeterminethe : there s u l to f a pre im in r y e x p n t vi g i o d m h  
thedeterminationofthenaturalfrequenciesandnormalmodesofvibration : the determination of natural frequencies and normal modes vibration  
theuseofstagecharacteristicsobtainedfromtestdataintheperformance : the use of stage characteristics obtained from test data in performance  
thisreporttreatsthekernelfunctionofanintegralequationthatrelates : this report treats the kernelfunction of an integral equation that relates  
arapidapproximatemethodofanalysiswasdevelopedforbothcompressible : Error 
statisticaltheoryingeneralconsidersmeanvaluesofcertainquantities : Error 
hypersonicflowatlowreynoldsnumberisstudiedutilizingtheshocklayer : hypersonic flow at low reynolds number is studied utilizing the shocklayer  
aninvestigationwasmadetodeterminetheinterferenceeffectsonsurface : an investigation was made to determine the interference effects on surface  
thisnotepresentssomephysicalinterpretationsofmagnetohydrodynamic : this note presents some physical interpretations of magnetohydrodynamic  
theconfluenthypergeometricfunctionshaveprovedusefulinmanybranches : the confluent hypergeometric functions have proved useful in many branches  
theexperimentallydeterminedinteractioneffectsofasidejetexhausting : the experimentally determined interaction effects of aside jet exhausting  
publishedexperimentalresultsareassembledtosupportapreviouslygiven : published experimental results areas s e m b ld to up p or t a r vi o u l y g iv n  
aninvestigationoftheeffectsoftheinteractionaheadofatwodimensional : an investigation of the effects interaction ahead at w o d im e n s i al  
anumericalsolutionispresentedtothetransientheatconductionequation : Error 
thisnotegivesformulaeandapproximationssuitableformakingpreliminary : this note gives formulae and approximations suitable form akin g preliminary  
incalculationsofthermodynamicheatingforhighspeedmissilesparameters : in calculations of thermodynamic heat g for h is p e d ms i l s a rm tr  
problemsonheatconductioninmultilayerbodiesleadusuallytocomplicated : Error 
astudyofexperimentalpressuredistributionsandsectioncharacteristics : Error 
designchartsbasedontheanalyticalsolutiontotheproblemofonedimensional : design charts based on the analytical so l u t i op r ob e m of d n s a  
thestabilityofcircularcylindricalshellsunderpurebendingisinvestigated : the stability of circularcylindrical shells under pure bending is investigated  
acomparisonismadeofseveraldifferentpropulsionsystemsforinterplanetary : a co m pr is on de of s e v rl d if f r n top u li y to it p l t  
